000008004
084016000
005001000
103800900
608000430
002009501
007002000
000780260
200300000